.....
.....#.####
.....###..#
...##.....#
..##...#..#
##.....#..#
.##..#..###
.#..#..#@##
.#..#..#.#
.#..#....#
.########